176	27
0	17	350	1	0	2
12	358	360	10	2	2	2	3
12	1800	385	10	1	1	11	3
12	1864	362	10	1	2	11	3
1	0	416	2	2	0	0	3
1	16	416	2	2	0	0	3
1	32	416	2	2	0	0	3
1	48	416	2	2	0	0	3
1	64	416	2	2	0	0	3
1	80	416	2	2	0	0	3
1	96	416	2	2	0	0	3
1	112	416	2	2	0	0	3
1	128	416	2	2	0	0	3
1	144	416	2	2	0	0	3
1	160	416	2	2	0	1	3
1	176	416	2	2	0	1	3
1	192	416	2	2	0	1	3
1	208	416	2	2	0	1	3
1	224	416	2	2	0	1	3
1	240	416	2	2	0	1	3
1	256	416	2	2	0	1	3
1	272	416	2	2	0	1	3
1	288	416	2	2	0	1	3
1	304	416	2	2	0	1	3
1	320	416	2	2	0	2	3
1	336	416	2	2	0	2	3
1	352	416	2	2	0	2	3
1	368	416	2	2	0	2	3
1	384	416	2	2	0	2	3
1	400	416	2	2	0	2	3
1	416	416	2	2	0	2	3
1	432	416	2	2	0	2	3
1	448	416	2	2	0	2	3
1	464	416	2	2	0	2	3
1	480	416	2	2	0	3	3
1	496	416	2	2	0	3	3
1	512	416	2	2	0	3	3
1	528	416	2	2	0	3	3
1	544	416	2	2	0	3	3
1	560	416	2	2	0	3	3
1	576	416	2	2	0	3	3
1	592	416	2	2	0	3	3
1	608	416	2	2	0	3	3
1	624	416	2	3	1	3	3
1	640	416	2	3	0	4	3
1	656	416	2	3	0	4	3
1	672	416	2	3	0	4	3
1	688	416	2	3	0	4	3
1	704	416	2	3	0	4	3
1	720	416	2	3	0	4	3
1	736	416	2	3	0	4	3
1	752	416	2	3	0	4	3
1	768	416	2	3	0	4	3
1	784	416	2	3	0	4	3
1	800	416	2	3	0	5	3
1	816	416	2	3	0	5	3
1	832	416	2	3	0	5	3
1	848	416	2	3	0	5	3
1	864	416	2	3	0	5	3
1	880	416	2	3	0	5	3
1	896	416	2	3	0	5	3
1	912	416	2	3	0	5	3
1	928	416	2	3	0	5	3
1	944	416	2	3	0	5	3
1	960	416	2	3	0	6	3
1	976	416	2	3	0	6	3
1	992	416	2	3	0	6	3
1	1008	416	2	3	0	6	3
1	1024	416	2	3	0	6	3
1	1040	416	2	3	0	6	3
1	1056	416	2	3	0	6	3
1	1072	416	2	3	1	6	3
1	624	400	2	2	1	3	3
1	640	400	2	2	0	4	3
1	656	400	2	2	0	4	3
1	672	400	2	2	0	4	3
1	688	400	2	2	0	4	3
1	704	400	2	2	0	4	3
1	720	400	2	2	0	4	3
1	736	400	2	2	0	4	3
1	752	400	2	2	0	4	3
1	768	400	2	2	0	4	3
1	784	400	2	2	0	4	3
1	800	400	2	2	0	5	3
1	816	400	2	2	0	5	3
1	832	400	2	2	0	5	3
1	848	400	2	2	0	5	3
1	864	400	2	2	0	5	3
1	880	400	2	2	0	5	3
1	896	400	2	2	0	5	3
1	912	400	2	2	0	5	3
1	928	400	2	2	0	5	3
1	944	400	2	2	0	5	3
1	960	400	2	2	0	6	3
1	976	400	2	2	0	6	3
1	992	400	2	2	0	6	3
1	1008	400	2	2	0	6	3
1	1024	400	2	2	0	6	3
1	1040	400	2	2	0	6	3
1	1056	400	2	2	0	6	3
1	1072	400	2	2	1	6	3
1	1152	416	2	2	1	7	3
1	1168	416	2	2	0	7	3
1	1184	416	2	2	0	7	3
1	1200	416	2	2	0	7	3
1	1216	416	2	2	0	7	3
1	1232	416	2	2	0	7	3
1	1248	416	2	2	0	7	3
1	1264	416	2	2	0	7	3
1	1280	416	2	2	0	8	3
1	1296	416	2	2	0	8	3
1	1312	416	2	2	0	8	3
1	1328	416	2	2	0	8	3
1	1344	416	2	2	0	8	3
1	1360	416	2	2	0	8	3
1	1376	416	2	2	0	8	3
1	1392	416	2	2	0	8	3
1	1408	416	2	2	0	8	3
1	1424	416	2	2	0	8	3
1	1440	416	2	2	0	9	3
1	1456	416	2	2	0	9	3
1	1472	416	2	2	0	9	3
1	1488	416	2	2	1	0	0	0	0	9	3
1	1504	336	2	4	1	9	2
1	1520	336	2	4	1	9	2
1	1536	416	2	2	1	9	3
1	1552	416	2	2	1	9	3
1	1568	416	2	2	1	9	3
1	1584	416	2	2	1	9	3
1	1600	416	2	2	1	0	0	0	0	10	3
1	1568	400	2	4	1	9	3
1	1584	400	2	4	1	9	3
1	1600	400	2	4	1	10	3
1	1584	384	2	4	1	9	3
1	1600	384	2	4	1	10	3
1	1600	368	2	4	1	10	3
1	1664	400	2	4	1	10	3
1	1680	400	2	4	0	10	3
1	1696	400	2	4	1	10	3
1	1664	384	2	4	1	10	3
1	1680	384	2	4	1	10	3
1	1664	368	2	4	1	10	3
1	1664	416	2	2	1	10	3
1	1680	416	2	2	0	10	3
1	1696	416	2	2	0	10	3
1	1712	416	2	2	0	10	3
1	1728	416	2	2	0	10	3
1	1744	416	2	2	0	10	3
1	1760	416	2	2	0	11	3
1	1776	416	2	2	0	11	3
1	1792	416	2	2	0	11	3
1	1808	416	2	2	0	11	3
1	1824	416	2	2	0	11	3
1	1840	416	2	2	0	11	3
1	1856	416	2	2	0	11	3
1	1872	416	2	2	0	11	3
1	1888	416	2	2	0	11	3
1	1904	416	2	2	0	11	3
1	1920	416	2	2	0	12	3
1	1936	416	2	2	0	12	3
1	1952	416	2	2	0	12	3
1	1968	416	2	2	0	12	3
1	1984	416	2	2	0	12	3
1	2000	416	2	2	0	12	3
1	2016	416	2	2	0	12	3
1	2032	416	2	2	0	12	3
1	2048	416	2	2	0	12	3
1	2064	416	2	2	0	12	3
1	2080	416	2	2	0	13	3
1	2096	416	2	2	0	13	3
1	2112	416	2	2	0	13	3
1	2128	416	2	2	0	13	3
1	2144	416	2	2	0	13	3
1	2160	416	2	2	0	13	3
1	2176	416	2	2	0	13	3
1	2192	416	2	2	0	13	3
1	2208	416	2	2	0	13	3
1	2224	416	2	2	1	13	3
1	2256	368	2	4	1	14	3
1	2272	368	2	4	1	14	3
1	2256	304	2	4	1	14	2
1	2272	304	2	4	1	14	2
1	2260	416	2	2	1	14	3
1	2272	416	2	2	0	14	3
1	2288	416	2	2	0	14	3
1	2304	416	2	2	0	14	3
1	2320	416	2	2	0	14	3
1	2336	416	2	2	0	14	3
1	2352	416	2	2	0	14	3
1	2368	416	2	2	0	14	3
1	2384	416	2	2	0	14	3
1	2400	416	2	2	0	15	3
1	2416	416	2	2	0	15	3
1	2432	416	2	2	0	15	3
1	2448	416	2	2	0	15	3
1	2464	416	2	2	0	15	3
1	2480	416	2	2	0	15	3
1	2496	416	2	2	0	15	3
1	2512	416	2	2	0	15	3
1	2528	416	2	2	0	15	3
1	2544	416	2	2	0	15	3
1	2560	416	2	2	0	16	3
1	2576	416	2	2	0	16	3
1	2592	416	2	2	0	16	3
1	2608	416	2	2	0	16	3
1	2624	416	2	2	0	16	3
1	2640	416	2	2	0	16	3
1	2656	416	2	2	0	16	3
1	2672	416	2	2	0	16	3
1	2688	416	2	2	0	16	3
1	2704	416	2	2	0	16	3
1	2720	416	2	2	0	17	3
1	2736	416	2	2	0	17	3
1	2752	416	2	2	0	17	3
1	2768	416	2	2	0	17	3
1	2784	416	2	2	0	17	3
1	2800	416	2	2	0	17	3
1	2816	416	2	2	0	17	3
1	1408	192	2	5	1	8	1
1	1424	192	2	5	0	8	1
1	1440	192	2	5	0	9	1
1	1456	192	2	5	1	9	1
1	1488	176	2	5	1	9	1
1	1504	176	2	5	0	9	1
1	1520	176	2	5	0	9	1
1	1536	176	2	5	0	9	1
1	1552	176	2	5	0	9	1
1	1568	176	2	5	0	9	1
1	1584	176	2	5	0	9	1
1	1600	176	2	5	0	10	1
1	1616	176	2	5	0	10	1
1	1632	176	2	5	0	10	1
1	1648	176	2	5	0	10	1
1	1664	176	2	5	0	10	1
1	1680	176	2	5	1	10	1
8	1952	400	2	1	12	3
8	1968	400	2	1	12	3
8	1984	400	2	1	12	3
8	2000	400	2	1	12	3
8	2016	400	2	1	12	3
8	2032	400	2	1	12	3
8	2048	400	2	1	12	3
8	1968	384	2	1	12	3
8	1984	384	2	1	12	3
8	2000	384	2	1	12	3
8	2016	384	2	1	12	3
8	2032	384	2	1	12	3
8	1984	368	2	1	12	3
8	2000	368	2	1	12	3
8	2016	368	2	1	12	3
9	2032	368	2	3	1	1	0	12	3
8	2096	400	2	1	13	3
8	2096	384	2	1	13	3
8	2112	400	2	1	13	3
9	176	352	2	1	1	0	1	1	2
9	192	352	2	1	1	0	1	1	2
9	224	304	2	1	1	0	1	1	2
9	240	304	2	1	1	1	0	1	2
9	416	320	2	1	1	0	1	2	2
9	656	384	2	1	1	1	0	4	3
9	704	352	2	1	1	0	1	4	2
9	1472	368	2	1	1	1	0	9	3
9	1440	128	2	2	1	1	0	9	1
2	192	391	3	1	1	3
2	512	391	3	1	3	3
2	912	383	3	1	5	3
2	976	383	3	1	6	3
2	1040	367	3	2	6	3
3	550	350	4	1	2	3	2
3	1440	300	4	2	1	9	2
3	1392	300	4	2	1	8	2
3	1344	300	4	2	1	8	2
3	1472	380	4	1	1	9	3
3	2020	330	4	1	2	12	2
4	240	368	0	288	416	1	3
4	272	337	0	320	416	1	2
4	405	368	0	480	416	2	3
4	464	336	0	528	416	2	2
4	512	304	0	576	416	3	2
4	512	384	0	608	416	3	3
4	1264	384	0	1376	416	7	3
4	1296	352	0	1408	416	8	2
4	1328	320	0	1440	416	8	2
4	1312	144	0	1376	176	8	1
4	2144	368	0	2192	416	13	3
4	2176	272	0	2224	416	13	2
5	1072	320	5	6	2
5	1104	288	5	6	2
5	1136	256	5	7	2
5	1168	224	5	7	1
5	1200	192	5	7	1
5	1328	80	5	8	0
5	1344	80	5	8	0
5	1360	80	5	8	0
5	1472	112	5	9	0
5	1488	112	5	9	0
5	1536	128	5	9	1
5	1552	128	5	9	1
5	1568	128	5	9	1
5	1584	128	5	9	1
5	1616	112	5	10	0
5	1632	112	5	10	0
5	1648	112	5	10	0
5	1664	112	5	10	0
5	1696	144	5	10	1
5	1728	112	5	10	0
5	1760	128	5	11	1
5	1808	96	5	11	0
5	1840	128	5	11	1
6	352	368	9	380	416	0	3	2	3
6	1794	384	9	1822	416	0	4	11	3
6	1858	368	9	1886	416	0	5	11	3
6	2258	384	9	2286	416	0	-1	14	3
6	2258	112	9	2286	304	2	1	14	0
6	2322	384	9	2350	416	0	-1	14	3
13	2688	335	7	16	2
