32	12
0	144	35	1	0	0
1	112	0	2	8	1	0	0
1	112	16	2	8	1	0	0
1	112	32	2	8	1	0	0
1	112	48	2	8	1	0	0
1	112	64	2	8	1	0	0
1	112	80	2	8	1	0	0
1	112	96	2	8	1	0	0
1	112	112	2	8	1	0	0
1	112	128	2	8	1	0	1
1	112	144	2	8	1	0	1
1	112	160	2	8	1	0	1
1	128	160	2	8	0	0	1
1	144	160	2	8	0	0	1
1	160	160	2	8	0	1	1
1	176	160	2	8	0	1	1
1	192	160	2	8	0	1	1
1	208	160	2	8	0	1	1
1	224	160	2	8	0	1	1
1	240	160	2	8	0	1	1
1	256	144	2	8	1	1	1
1	272	128	2	8	1	1	1
1	288	112	2	8	1	1	0
1	304	96	2	8	1	1	0
1	320	80	2	8	1	2	0
1	336	64	2	8	1	2	0
1	352	64	2	8	0	2	0
1	368	64	2	8	0	2	0
1	384	48	2	8	1	2	0
1	384	32	2	8	1	2	0
1	384	16	2	8	1	2	0
1	384	0	2	8	1	2	0
1	160	0	2	8	0	1	0
1	176	0	2	8	0	1	0
1	192	0	2	8	0	1	0
1	208	0	2	8	0	1	0
1	224	0	2	8	0	1	0
1	240	0	2	8	0	1	0
1	256	0	2	8	0	1	0
1	272	0	2	8	0	1	0
1	288	0	2	8	0	1	0
1	304	0	2	8	0	1	0
1	320	0	2	8	0	2	0
1	336	0	2	8	0	2	0
5	210	41	5	1	0
5	226	25	5	1	0
5	242	25	5	1	0
5	258	41	5	1	0
5	258	57	5	1	0
5	226	73	5	1	0
5	242	73	5	1	0
5	258	89	5	1	0
5	258	105	5	1	0
5	242	121	5	1	1
5	226	121	5	1	1
5	210	105	5	1	0
6	128	0	9	159	31	0	-1	0	0
6	352	0	9	383	31	1	2	2	0
